"filename", "language", "C++", "C", "Markdown", "comment", "blank", "total"
"g:\MyClasses\DataBaseSystem\HITSZ-DB\DB-Exp4\README.md", "Markdown", 0, 0, 1, 0, 1, 2
"g:\MyClasses\DataBaseSystem\HITSZ-DB\DB-Exp4\buftool.c", "C", 0, 99, 0, 60, 27, 186
"g:\MyClasses\DataBaseSystem\HITSZ-DB\DB-Exp4\disktool.c", "C", 0, 213, 0, 81, 43, 337
"g:\MyClasses\DataBaseSystem\HITSZ-DB\DB-Exp4\extmem.c", "C", 0, 119, 0, 53, 28, 200
"g:\MyClasses\DataBaseSystem\HITSZ-DB\DB-Exp4\extmem.h", "C++", 21, 0, 0, 19, 13, 53
"g:\MyClasses\DataBaseSystem\HITSZ-DB\DB-Exp4\main.c", "C", 0, 55, 0, 29, 18, 102
"g:\MyClasses\DataBaseSystem\HITSZ-DB\DB-Exp4\merger.c", "C", 0, 196, 0, 11, 20, 227
"g:\MyClasses\DataBaseSystem\HITSZ-DB\DB-Exp4\merger.h", "C++", 19, 0, 0, 0, 5, 24
"g:\MyClasses\DataBaseSystem\HITSZ-DB\DB-Exp4\selector.c", "C", 0, 268, 0, 47, 53, 368
"g:\MyClasses\DataBaseSystem\HITSZ-DB\DB-Exp4\selector.h", "C++", 15, 0, 0, 4, 5, 24
"g:\MyClasses\DataBaseSystem\HITSZ-DB\DB-Exp4\sorttool.c", "C", 0, 48, 0, 9, 10, 67
"g:\MyClasses\DataBaseSystem\HITSZ-DB\DB-Exp4\utils.h", "C++", 65, 0, 0, 13, 21, 99
"Total", "-", 120, 998, 1, 326, 244, 1689