"filename", "language", "C", "C++", "Markdown", "comment", "blank", "total"
"g:\MyClasses\DataBaseSystem\HITSZ-DB\DB-Exp4\README.md", "Markdown", 0, 0, 1, 0, 1, 2
"g:\MyClasses\DataBaseSystem\HITSZ-DB\DB-Exp4\buftool.c", "C", 99, 0, 0, 60, 27, 186
"g:\MyClasses\DataBaseSystem\HITSZ-DB\DB-Exp4\disktool.c", "C", 212, 0, 0, 82, 44, 338
"g:\MyClasses\DataBaseSystem\HITSZ-DB\DB-Exp4\extmem.c", "C", 119, 0, 0, 52, 28, 199
"g:\MyClasses\DataBaseSystem\HITSZ-DB\DB-Exp4\extmem.h", "C++", 0, 21, 0, 19, 13, 53
"g:\MyClasses\DataBaseSystem\HITSZ-DB\DB-Exp4\main.c", "C", 91, 0, 0, 8, 20, 119
"g:\MyClasses\DataBaseSystem\HITSZ-DB\DB-Exp4\merger.c", "C", 347, 0, 0, 28, 62, 437
"g:\MyClasses\DataBaseSystem\HITSZ-DB\DB-Exp4\merger.h", "C++", 0, 24, 0, 0, 6, 30
"g:\MyClasses\DataBaseSystem\HITSZ-DB\DB-Exp4\selector.c", "C", 189, 0, 0, 25, 48, 262
"g:\MyClasses\DataBaseSystem\HITSZ-DB\DB-Exp4\selector.h", "C++", 0, 16, 0, 4, 5, 25
"g:\MyClasses\DataBaseSystem\HITSZ-DB\DB-Exp4\snap.c", "C", 64, 0, 0, 0, 14, 78
"g:\MyClasses\DataBaseSystem\HITSZ-DB\DB-Exp4\sorttool.c", "C", 64, 0, 0, 9, 10, 83
"g:\MyClasses\DataBaseSystem\HITSZ-DB\DB-Exp4\tpmmtool.c", "C", 114, 0, 0, 45, 5, 164
"g:\MyClasses\DataBaseSystem\HITSZ-DB\DB-Exp4\utils.h", "C++", 0, 138, 0, 33, 37, 208
"Total", "-", 1299, 199, 1, 365, 320, 2184